############
#........#
#........#
#........#
#........#
#....@...#
#........#
#........#
#........#
############