###....###
#........#
#........#
...#..#...
....@....
..........
..........
#........#
#........#
###....###




