...#..
..#....#.#.
..@...##..#
##.........
..........#
###..#.#...
..#...#....
.##..#.####
.#......#.
.......##
.###.#.#