############
#........#
#.#...#..#
#........#
#..#.....#
#.#..@...#
#........#
#..#...#.#
#.....#..#
############