############
#........#
#........#
#........#
#...@....#
#........#
#........#
#........#
#........#
############