############
#........#
#.#...#..#
#........#
#..#.....#
#.#......#
#........#
#..#...#.#
#.....#@.#
############