...#..
..#....#.#.
......##..#
##.........
..........#
###.@#.#...
..#...#....
.##..#.####
.#......#.
.......##
.###.#.#